1111111111111
100100000C001
1000011111C01
100P01E000001
1111111111111
