11111111111111111111
10100000C00000000001
1000011111C00000C001
100P01E1000000000001
11111111111111111111
