11111111111111111111
11111111111111111111
1111111PEC1111111111
11111111111111111111
11111111111111111111
